11111111111111111111111111111111111111111111111111111111111111111
1000000000000000C000000000000000000000001100000000000000000000001
100C00000000000CCC00000000001000000000000111111111111111111111111
1000000000000CCCPCCC000000000100000010000000000000000000000000001
100111100000000CCC000000000001000000001000000000000000000000000E1
10000C1000000000C00000000000000000C000111111111111111111111111111
10000010000000000000000000000000000011000000000000000000000000001
11111111111111111111111111111111111111111111111111111111111111111