1111111
1P000E1
1000001
10000C1
1111111