11111111111111111111111111111111111
100000000000000C0000000000000000001
10C0000F000000CCC000000000100000001
100000001000CCCPCCC01010000100F0001
10111100000000CCC000001000010000001
100FC1000000000C00000F0001100000C01
1000010000000000000C000010000000001
11111111111111111111111111000C00001
100000000000000000000000010000000F1
10000000000000000000000001000000F01
1000000000000000000000000100000F001
100000000000000000000000100000F0C01
10000000000111100000000100000000C01
10000000011000011111111000000000001
100000000100E00000000000000000F0001
11111111111111111111111111111111111