11111111111111111111111111111111111
100000000000000C0000000000000000001
10C0000F000000CCC000000000100000001
100000001000CC0PCCC01010000100F0001
10111100000010CCC000001000010000001
100F00100000000C000F0F0001100000C01
1000C010000C0000000C0000100000E0001
11111111111111111111111111111111111