11111111111111111111111111111111111
100000000000000C0000000000000000001
10C0000F000000CCC000000000100000001
100000001000CCCPCCC01010000100F0001
10111100000000CCC000001000010000001
100FC1000000000C0000000001100000C01
100001000000000000000000100000E0001
11111111111111111111111111111111111