1111111111111111111111111111111
1P00000000000000000000000000001
1111111111111110000000000000001
1000000000000010000000000000001
1011111111100010111111111111111
1010000000100010000000000000001
1010000000100011111111111111101
1010111110100000000000000000101
1010100011101111111111111110101
1010100010000000000000000000101
1010111011111111111111101111101
1010000010000000000000100000101
1011111010111111111011111110101
1000000010000000000000000000101
1011111111111111111111111111101
10000000000000000000000000000E1
1111111111111111111111111111111